pravoslavnie_hristiane	religion
slovodobroe	religion
pravoslavie_ru	religion
okean_mudrosti	religion
pravoclavie	religion
muslimsislam	religion
risalatru	religion
islamhuda	religion
faceumma	religion
gelug	religion
buddha_dhamma	religion
dzenbuddizm34	religion
pogovorim_o_svoem	food
vse_dlya_hozyaek	food
cookrutxt	food
real_jamvk	food
nyamushka	food
recepty_pravilnogo_pitaniya	food
pro100_eda	food
akademiarosta_chudochado	food
vkusn_shedevri	food
liketocook	food
best_movies	film
exp.film	film
feokino	film
films_for_soul	film
hd_vkino	film
hdfilm5	film
hdkino_2015	film
in.kino	film
kin__o	film
kino_kaif	film
kino_maksa	film
kino_mania	film
kino_vk	film
kino.media	film
m_kinos	film
melodrami	film
refilms	film
skafilms	film
territoriya.kino	film
xfilm	film
anti_usa_news	vata
usabitch	vata
rusarmi	vata
newsoldat	vata
vegchelru	vata
vegchel	vata
antimaydan	vata
narodnay_druzina	vata
infonod	vata
nstarikov_club	vata
e_music	music
topdjcom	music
indie_music	music
tipicalgitara	music
modern_rock_music	music
yandexmusic	music
vkmusic	music
another_muz	music
mzk	music
artmelody	music
classicmusic	music
besplatno_zarepostik	gifts
free_gift_in_ukraine	gifts
gifts_za_repost	gifts
best_gifts_for_you	gifts
darim_m	gifts
club123571663	gifts
x_foryou	gifts
prizmne	gifts
podarki.zarepost	gifts
xaliavazarepost	gifts
club135312245	gifts
repostpodar0k	gifts
money1917	gifts
dengizareposst	gifts
muslimpodarki	gifts
club102115202	gifts
freezareepost	gifts
yarkiedetki	shopping
spamazon	shopping
teritorriastilia	shopping
sp.karamel	shopping
sovmestnaya_pokupka_opt	shopping
slikvida	shopping
budget1	shopping
spvsepokarmanu	shopping
1sp.ukraine	shopping
sp_ukrainian	shopping
mother_care	shopping
poisk_official_ua	shopping
mvgtaobao	shopping
ladysklub	shopping
ellfashion	shopping
viruskoronaviruskorona	covid
coronavirus67	covid
stopcoronavirusrf	covid
covid2019_official	covid
covid_murman	covid
coronavirusx	covid
whoinrussia	covid
coronavirus_43	covid